 111111111111111
1100000000000001
1000001111000001
1100001  100001111111111
 10000111100000000000001
 1000000000000E111111111
 110111111111111
 10001
 11111