 111111111111111
1100000000000001000
1000001110000001
1100001 10000011
 100001 10000001
 1000000000000W11111111
 111111111111111