 111111111111111
1100000000000001
1000001111000001
1100001  100001111111111
 1000011110E000000000001
 1000000000000111111111
 1101111111111111
 10001
 11111