 111111111111111
1100000000000001000
1000001110000001
1100001 10000011
 100001110000001
 1000000000E00011111111
 111111111111111