F 150,134,122
C 141,158,214

NO ./textures/bluestone.xpm
SO ./textures/colorstone.xpm
WE ./textures/greystone.xpm
EA ./textures/redbrick.xpm

11111
10001
10N01
10001
11111